17
6
4
1
..#####..........
..#...####.###...
###.T.##T#.#M#...
#TE...#.E###E####
###............B#
#################